Blank,Cast,Favour,Opposed,Received_by_voters,Fail_delivered,Type,Result,Total_number
0,18,16,1,34,0,Front Yard Parking,Yes,34
0,30,30,0,36,0,Front Yard Parking,Yes,36
0,43,37,3,91,6,Front Yard Parking,Yes,97
0,137,101,31,316,18,Traffic Calming,No,334
0,30,19,10,103,3,Boulevard Cafe,Yes,106
0,63,42,20,202,33,Traffic Calming,No,235
0,26,13,11,204,31,Commercial Boulevard Parking,No,235
0,35,29,1,99,10,Appeal - Front Yard Parking,Yes,109
0,101,44,27,332,8,Traffic Calming,No,340
0,48,44,3,79,1,Front Yard Parking,Yes,80
0,36,32,0,72,1,Front Yard Parking,Yes,73
0,24,19,5,43,0,Traffic Calming,Yes,43
0,55,47,8,78,0,Traffic Calming,Yes,78
0,3,0,3,15,1,Boulevard Cafe,No,16
0,54,43,10,89,1,Traffic Calming,Yes,90
2,82,63,13,131,7,Traffic Calming,Yes,138
0,134,99,33,261,10,Traffic Calming,Yes,271
0,87,63,23,250,11,Traffic Calming,No,261
0,68,44,17,133,5,Traffic Calming,Yes,138
0,1,1,0,9,15,Boulevard Cafe,No,24
0,2,1,1,6,5,Traffic Calming,No,11
0,31,18,11,145,6,Boulevard Cafe,No,151
0,27,21,1,89,3,Boulevard Cafe,Yes,92
0,30,23,1,73,3,Boulevard Cafe,Yes,76
0,50,45,3,139,7,Boulevard Cafe,Yes,146
0,25,23,0,59,0,Appeal - Front Yard Parking,Yes,59
0,29,11,16,73,2,Appeal - Front Yard Parking,Yes,75
2,41,34,2,80,7,Appeal - Front Yard Parking,Yes,87
0,41,37,1,53,6,Appeal - Front Yard Parking,Yes,59
0,31,21,4,65,0,Appeal - Front Yard Parking,Yes,65
0,56,31,16,105,8,Appeal - Front Yard Parking,Yes,113
0,0,0,0,22,0,Boulevard Cafe,No,22
0,39,18,18,88,12,Traffic Calming,No,100
0,34,22,9,53,1,Traffic Calming,Yes,54
0,17,16,0,29,0,Front Yard Parking,Yes,29
0,26,10,8,60,6,Boulevard Cafe,Yes,66
0,0,0,0,14,4,Boulevard Cafe,No,18
2,35,32,1,43,0,Boulevard Cafe,Yes,43
0,33,4,23,66,1,Appeal - Front Yard Parking,Yes,67
0,20,20,0,37,3,Appeal - Front Yard Parking,Yes,40
0,47,33,5,83,1,Appeal - Front Yard Parking,Yes,84
0,48,32,10,127,0,Appeal - Front Yard Parking,Yes,127
0,36,30,5,81,5,Traffic Calming,No,86
0,27,20,2,96,5,Appeal - Front Yard Parking,Yes,101
0,24,20,2,50,6,Appeal - Front Yard Parking,Yes,56
0,26,24,2,30,0,Appeal - Front Yard Parking,Yes,30
0,48,45,2,75,2,Appeal - Front Yard Parking,Yes,77
0,29,20,2,91,3,Front Yard Parking,Yes,94
0,28,20,6,93,5,Boulevard Cafe,Yes,98
0,30,1,28,65,0,Boulevard Cafe,Yes,65
0,42,35,3,94,5,Appeal - Front Yard Parking,Yes,99
0,19,12,4,34,0,Appeal - Front Yard Parking,Yes,34
0,6,5,1,48,8,Traffic Calming,No,56
0,40,19,18,102,4,Traffic Calming,No,106
0,104,57,38,287,28,Boulevard Cafe,Yes,315
0,215,170,40,355,3,Traffic Calming,Yes,358
0,54,46,4,95,2,Front Yard Parking,Yes,97
0,37,19,15,86,0,Traffic Calming,No,86
0,44,28,15,69,0,Traffic Calming,Yes,69
0,59,31,25,73,2,Traffic Calming,Yes,75
0,21,14,7,126,8,Boulevard Cafe,No,134
0,22,14,7,48,5,Front Yard Parking,Yes,53
0,20,14,5,48,3,Front Yard Parking,Yes,51
0,90,60,18,298,16,Traffic Calming,No,314
0,54,42,5,149,5,Appeal - Front Yard Parking,Yes,154
0,68,48,12,105,2,Appeal - Front Yard Parking,Yes,107
0,14,14,0,38,3,Front Yard Parking,Yes,41
0,45,30,15,73,1,Appeal - Front Yard Parking,Yes,74
0,76,38,33,138,10,Appeal - Front Yard Parking,Yes,148
0,60,58,0,91,6,Appeal - Front Yard Parking,Yes,97
0,14,11,3,34,2,Proposed Business Improvement Area,Yes,36
0,8,5,3,9,2,Permit Parking,Yes,11
0,35,11,21,83,10,Boulevard Cafe,Yes,93
0,51,30,14,95,6,Appeal - Front Yard Parking,Yes,101
1,54,48,2,104,7,Appeal - Front Yard Parking,Yes,111
0,15,13,0,46,0,Appeal - Front Yard Parking,Yes,46
0,27,26,0,35,0,Appeal - Front Yard Parking,Yes,35
0,70,67,0,115,0,Appeal - Front Yard Parking,Yes,115
0,38,29,8,115,8,Appeal - Front Yard Parking,Yes,123
0,12,8,4,33,2,Appeal - Front Yard Parking,Yes,35
0,24,15,6,33,0,Front Yard Parking,Yes,33
0,21,21,0,32,0,Front Yard Parking,Yes,32
0,20,20,0,52,0,Front Yard Parking,Yes,52
0,24,19,1,38,0,Front Yard Parking,Yes,38
0,150,119,21,313,6,Traffic Calming,No,319
0,60,28,28,270,24,Permit Parking,No,294
0,25,23,0,47,2,Appeal - Front Yard Parking,Yes,49
0,23,20,0,67,1,Front Yard Parking,Yes,68
0,46,33,7,88,7,Appeal - Front Yard Parking,Yes,95
0,45,45,0,73,1,Front Yard Parking,Yes,74
0,38,36,0,77,1,Front Yard Parking,Yes,78
0,37,28,3,80,5,Appeal - Front Yard Parking,Yes,85
0,11,5,5,83,3,Commercial Boulevard Parking,No,86
0,11,5,6,26,2,Commercial Boulevard Parking,Yes,28
0,10,4,6,84,1,Commercial Boulevard Parking,No,85
0,49,39,7,97,6,Front Yard Parking,Yes,103
0,13,12,0,26,2,Front Yard Parking,Yes,28
0,32,30,1,111,3,Front Yard Parking,Yes,114
0,30,21,3,58,7,Front Yard Parking,Yes,65
0,34,25,8,143,10,Front Yard Parking,No,153
0,54,50,0,80,22,Front Yard Parking,Yes,102
0,88,59,11,197,8,Traffic Calming,No,205
0,63,54,2,100,0,Front Yard Parking,Yes,100
0,47,45,0,99,1,Front Yard Parking,Yes,100
0,17,16,0,34,5,Front Yard Parking,Yes,39
0,46,39,6,123,21,Front Yard Parking,Yes,144
0,21,21,0,43,3,Front Yard Parking,Yes,46
0,24,24,0,37,0,Front Yard Parking,Yes,37
0,22,19,3,29,0,Appeal - Front Yard Parking,Yes,29
0,39,23,6,82,2,Appeal - Front Yard Parking,Yes,84
0,23,6,17,46,2,Appeal - Front Yard Parking,Yes,48
0,66,43,10,134,13,Appeal - Front Yard Parking,Yes,147
0,15,14,0,46,1,Appeal - Front Yard Parking,Yes,47
0,19,19,0,39,3,Appeal - Front Yard Parking,Yes,42
0,20,18,2,47,15,Proposed Business Improvement Area,Yes,62
0,302,201,40,1501,136,Traffic Calming,No,1637
0,137,44,77,406,45,Traffic Calming,No,451
0,31,28,0,50,0,Front Yard Parking,Yes,50
0,32,31,0,87,4,Front Yard Parking,Yes,91
0,44,26,10,132,14,Front Yard Parking,Yes,146
0,36,25,3,54,6,Appeal - Front Yard Parking,Yes,60
0,360,194,146,1111,201,Traffic Calming,No,1312
0,105,68,27,395,369,Traffic Calming,No,764
0,34,24,5,81,2,Traffic Calming,No,83
0,23,18,3,34,0,Traffic Calming,Yes,34
0,32,32,0,61,1,Front Yard Parking,Yes,62
0,42,35,1,75,4,Front Yard Parking,Yes,79
0,108,78,28,232,38,Traffic Calming,No,270
0,37,1,35,74,7,Boulevard Cafe,Yes,81
0,206,103,84,300,5,Traffic Calming,Yes,305
0,122,96,16,180,9,Traffic Calming,Yes,189
0,199,84,101,290,7,Traffic Calming,Yes,297
0,301,178,94,1441,211,Traffic Calming,No,1652
0,47,34,10,79,8,Traffic Calming,Yes,87
0,6,3,1,69,13,Boulevard Cafe,No,82
0,22,9,13,53,0,Permit Parking,Yes,53
0,66,37,22,99,7,Traffic Calming,Yes,106
0,23,22,0,75,2,Appeal - Front Yard Parking,Yes,77
0,44,41,0,82,5,Front Yard Parking,Yes,87
0,41,38,2,97,8,Front Yard Parking,Yes,105
0,11,7,4,22,0,Front Yard Parking,Yes,22
0,30,26,4,69,12,Appeal - Front Yard Parking,Yes,81
0,33,24,2,106,4,Appeal - Front Yard Parking,Yes,110
0,60,44,13,128,13,Appeal - Front Yard Parking,Yes,141
0,30,27,2,87,1,Appeal - Front Yard Parking,Yes,88
0,21,10,11,96,5,Permit Parking,No,101
0,48,22,26,90,0,Permit Parking,Yes,90
0,36,13,23,88,1,Permit Parking,Yes,89
0,45,42,0,84,0,Front Yard Parking,Yes,84
0,29,28,1,42,4,Front Yard Parking,Yes,46
0,39,26,13,124,6,Appeal - Front Yard Parking,Yes,130
0,51,35,14,76,11,Traffic Calming,Yes,87
0,26,22,1,41,17,Appeal - Front Yard Parking,Yes,58
0,14,13,0,20,1,Appeal - Front Yard Parking,Yes,21
0,17,17,0,24,2,Appeal - Front Yard Parking,Yes,26
0,34,25,7,62,0,Appeal - Front Yard Parking,Yes,62
0,78,57,10,131,9,Front Yard Parking,Yes,140
0,34,33,1,79,6,Appeal - Front Yard Parking,Yes,85
0,18,16,1,60,2,Appeal - Front Yard Parking,Yes,62
0,25,10,14,56,4,Permit Parking,Yes,60
0,46,37,4,109,8,Front Yard Parking,Yes,117
0,66,45,18,106,19,Front Yard Parking,Yes,125
0,40,35,0,105,4,Front Yard Parking,Yes,109
0,45,40,2,77,0,Appeal - Front Yard Parking,Yes,77
0,60,49,9,126,4,Traffic Calming,No,130
0,55,36,17,109,5,Boulevard Cafe,Yes,114
0,66,38,20,120,11,Appeal - Front Yard Parking,Yes,131
0,18,17,1,45,8,Appeal - Front Yard Parking,Yes,53
0,48,25,21,132,4,Appeal - Front Yard Parking,Yes,136
0,28,18,7,60,1,Appeal - Front Yard Parking,Yes,61
0,44,26,14,104,4,Appeal - Front Yard Parking,Yes,108
0,39,32,3,114,2,Appeal - Front Yard Parking,Yes,116
0,55,44,2,78,1,Front Yard Parking,Yes,79
0,9,0,9,14,9,Permit Parking,Yes,23
0,66,36,16,137,13,Permit Parking,Yes,150
0,53,36,12,133,5,Traffic Calming,No,138
0,28,21,3,67,2,Appeal - Front Yard Parking,Yes,69
0,258,133,79,1628,219,Permit Parking,No,1847
0,46,17,25,140,3,Traffic Calming,No,143
0,130,66,38,447,48,Traffic Calming,No,495
0,15,14,0,17,6,Front Yard Parking,Yes,23
0,971,536,382,2073,351,Traffic Calming,No,2424
0,87,81,1,144,15,Front Yard Parking,Yes,159
0,6,1,3,40,5,Commercial Boulevard Parking,No,45
0,1,0,0,42,4,Commercial Boulevard Parking,No,46
0,49,43,2,82,0,Front Yard Parking,Yes,82
0,46,39,5,72,1,Front Yard Parking,Yes,73
0,10,3,5,42,9,Boulevard Cafe,No,51
0,53,27,25,108,9,Appeal - Front Yard Parking,Yes,117
0,57,37,15,87,12,Boulevard Cafe,Yes,99
0,48,32,11,109,6,Appeal - Front Yard Parking,Yes,115
0,49,27,18,130,15,Appeal - Front Yard Parking,Yes,145
0,30,25,3,62,6,Front Yard Parking,Yes,68
0,24,14,5,123,6,Boulevard Cafe,No,129
0,55,46,2,112,4,Traffic Calming,No,116
0,34,6,26,55,3,Appeal - Front Yard Parking,Yes,58
0,14,14,0,28,0,Front Yard Parking,Yes,28
0,99,87,2,229,24,Appeal - Front Yard Parking,Yes,253
0,64,53,9,150,1,Appeal - Front Yard Parking,Yes,151
0,15,6,3,82,13,Boulevard Cafe,No,95
0,18,16,2,51,12,Traffic Calming â€“ Island,No,63
0,46,34,6,78,5,Front Yard Parking,Yes,83
0,23,8,15,37,0,Appeal - Front Yard Parking,Yes,37
0,39,23,10,132,6,Appeal - Front Yard Parking,Yes,138
0,48,12,31,77,3,Appeal - Front Yard Parking,Yes,80
0,36,24,10,84,1,Appeal - Front Yard Parking,Yes,85
0,54,46,4,86,0,Front Yard Parking,Yes,86
0,63,54,2,96,0,Front Yard Parking,Yes,96
0,37,17,19,128,3,Boulevard Cafe,Yes,131
0,16,11,4,64,2,Appeal - Front Yard Parking,Yes,66
0,14,12,0,95,9,Boulevard Cafe,No,104
0,27,8,19,76,0,Boulevard Cafe,Yes,76
0,12,9,1,37,7,Boulevard Cafe,Yes,44
0,8,6,2,24,5,Proposed Business Improvement Area,Yes,29
0,36,25,5,61,0,Front Yard Parking,Yes,61
0,60,52,4,124,2,Front Yard Parking,Yes,126
0,29,21,8,91,7,Appeal - Front Yard Parking,Yes,98
0,16,12,3,25,0,Traffic Calming,Yes,25
0,2,2,0,37,2,Boulevard Cafe,No,39
0,25,21,4,49,2,Traffic Calming,No,51
0,64,51,0,145,8,Front Yard Parking,Yes,153
0,41,24,6,66,3,Appeal - Front Yard Parking,Yes,69
0,14,14,0,51,0,Appeal - Front Yard Parking,Yes,51
0,67,61,6,129,20,Appeal - Front Yard Parking,Yes,149
0,73,64,5,111,6,Appeal - Front Yard Parking,Yes,117
0,76,67,5,111,6,Appeal - Front Yard Parking,Yes,117
0,23,4,19,63,0,Boulevard Cafe,Yes,63
0,73,53,15,163,3,Traffic Calming,No,166
0,74,57,7,190,22,Front Yard Parking,Yes,212
0,88,50,30,137,3,Traffic Calming,Yes,140
0,39,32,2,61,2,Traffic Calming,Yes,63
0,37,33,4,66,1,Front Yard Parking,Yes,67
0,26,21,2,50,1,Appeal - Front Yard Parking,Yes,51
0,58,44,5,89,0,Appeal - Front Yard Parking,Yes,89
0,24,20,2,27,2,Front Yard Parking,Yes,29
0,17,10,5,35,0,Appeal - Front Yard Parking,Yes,35
0,4,2,0,6,0,Permit Parking,Yes,6
0,25,18,7,76,40,Traffic Calming,No,116
0,77,57,14,173,2,Traffic Calming,No,175
0,41,40,1,92,1,Front Yard Parking,Yes,93
0,16,2,13,47,0,Boulevard Cafe,Yes,47
0,19,13,4,23,0,Appeal - Front Yard Parking,Yes,23
0,43,41,1,45,0,Front Yard Parking,Yes,45
0,61,38,18,137,6,Boulevard Cafe,Yes,143
0,29,14,13,134,15,Boulevard Cafe,No,149
0,9,6,0,34,0,Boulevard Cafe,Yes,34
0,20,16,2,67,4,Boulevard Cafe,Yes,71
0,33,31,0,93,2,Appeal - Front Yard Parking,Yes,95
0,96,85,2,118,1,Front Yard Parking,Yes,119
0,56,26,23,108,6,Front Yard Parking,Yes,114
0,49,37,7,66,4,Appeal - Front Yard Parking,Yes,70
0,44,34,2,108,2,Front Yard Parking,Yes,110
0,49,46,1,75,1,Front Yard Parking,Yes,76
0,71,54,14,126,4,Front Yard Parking,Yes,130
0,11,5,5,43,1,Boulevard Cafe,Yes,44
0,12,10,2,22,1,Front Yard Parking,Yes,23
0,43,19,22,72,0,Traffic Calming,Yes,72
0,34,24,9,61,3,Traffic Calming,Yes,64
0,7,2,5,13,0,Boulevard Cafe,Yes,13
0,11,5,6,25,5,Traffic Calming,No,30
0,76,43,27,109,7,Traffic Calming,Yes,116
0,89,46,28,236,83,Traffic Calming,No,319
0,94,61,24,159,29,Traffic Calming,Yes,188
0,25,25,0,57,7,Traffic Calming,No,64
0,57,39,5,102,1,Front Yard Parking,Yes,103
0,41,35,1,70,0,Front Yard Parking,Yes,70
0,30,30,0,48,0,Appeal - Front Yard Parking,Yes,48
0,71,46,22,130,3,Appeal - Front Yard Parking,Yes,133
0,41,38,2,77,1,Front Yard Parking,Yes,78
0,92,74,8,182,12,Appeal - Front Yard Parking,Yes,194
0,26,26,0,41,3,Front Yard Parking,Yes,44
0,7,6,1,15,0,Appeal - Front Yard Parking,Yes,15
0,35,32,1,43,3,Front Yard Parking,Yes,46
0,28,7,13,117,10,Boulevard Cafe,No,127
0,204,138,48,443,18,Traffic Calming,No,461
0,3,1,2,14,0,Boulevard Cafe,No,14
0,30,2,25,114,1,Boulevard Cafe,Yes,115
0,37,25,11,96,22,Boulevard Cafe,Yes,118
0,26,17,5,101,13,Boulevard Cafe,Yes,114
0,29,23,0,64,2,Boulevard Cafe,Yes,66
0,0,0,0,5,0,Boulevard Cafe,No,5
0,26,17,9,71,0,Appeal - Front Yard Parking,Yes,71
0,105,76,24,224,1,Traffic Calming,No,225
0,63,60,0,111,5,Appeal - Front Yard Parking,Yes,116
0,46,35,6,120,5,Appeal - Front Yard Parking,Yes,125
0,10,10,0,12,0,Front Yard Parking,Yes,12
0,26,22,1,40,0,Front Yard Parking,Yes,40
0,32,22,8,81,0,Appeal - Front Yard Parking,Yes,81
0,50,48,0,88,0,Front Yard Parking,Yes,88
0,28,27,1,40,1,Front Yard Parking,Yes,41
0,40,30,7,64,0,Front Yard Parking,Yes,64
0,58,41,1,91,5,Front Yard Parking,Yes,96
0,31,27,0,105,7,Appeal - Front Yard Parking,Yes,112
0,55,48,5,110,7,Appeal - Front Yard Parking,Yes,117
0,71,65,3,128,8,Front Yard Parking,Yes,136
0,48,44,1,81,2,Front Yard Parking,Yes,83
0,40,31,2,74,10,Appeal - Front Yard Parking,Yes,84
0,36,30,4,82,3,Appeal - Front Yard Parking,Yes,85
0,22,16,5,110,30,Appeal - Front Yard Parking,No,140
0,27,22,4,31,0,Traffic Calming,Yes,31
0,57,55,0,68,6,Front Yard Parking,Yes,74
0,49,47,0,105,1,Front Yard Parking,Yes,106
0,72,49,4,144,9,Appeal - Front Yard Parking,Yes,153
0,36,31,2,101,5,Appeal - Front Yard Parking,Yes,106
0,26,15,10,30,0,Traffic Calming â€“ Island,Yes,30
0,15,13,0,49,1,Front Yard Parking,Yes,50
0,32,21,1,93,0,Front Yard Parking,Yes,93
0,10,4,6,18,2,Boulevard Cafe,Yes,20
0,243,170,39,532,37,Traffic Calming,No,569
0,41,36,3,90,2,Appeal - Front Yard Parking,Yes,92
0,40,30,6,73,0,Appeal - Front Yard Parking,Yes,73
0,43,24,17,136,0,Appeal - Front Yard Parking,Yes,136
0,26,22,0,40,0,Appeal - Front Yard Parking,Yes,40
0,42,32,8,120,1,Appeal - Front Yard Parking,Yes,121
0,42,29,7,108,1,Appeal - Front Yard Parking,Yes,109
0,37,27,5,70,0,Appeal - Front Yard Parking,Yes,70
0,47,27,13,128,2,Appeal - Front Yard Parking,Yes,130
0,50,32,16,127,3,Appeal - Front Yard Parking,Yes,130
0,25,19,1,44,3,Appeal - Front Yard Parking,Yes,47
0,28,17,4,156,6,Boulevard Cafe,No,162
0,47,43,1,69,1,Front Yard Parking,Yes,70
0,5,2,3,27,4,Permit Parking,No,31
0,57,41,6,104,1,Front Yard Parking,Yes,105
0,45,23,20,85,5,Appeal - Front Yard Parking,Yes,90
0,49,38,0,79,4,Front Yard Parking,Yes,83
0,33,29,4,57,2,Front Yard Parking,Yes,59
0,39,31,4,82,0,Front Yard Parking,Yes,82
0,26,25,1,79,4,Front Yard Parking,Yes,83
0,27,26,1,37,16,Front Yard Parking,Yes,53
0,65,55,5,126,9,Appeal - Front Yard Parking,Yes,135
0,44,38,0,83,9,Appeal - Front Yard Parking,Yes,92
0,47,45,0,69,1,Appeal - Front Yard Parking,Yes,70
0,37,18,12,90,3,Appeal - Front Yard Parking,Yes,93
0,23,11,11,57,7,Commercial Boulevard Parking,Yes,64
0,38,13,23,100,4,Front Yard Parking,Yes,104
0,67,52,10,141,15,Front Yard Parking,Yes,156
0,41,28,6,74,0,Front Yard Parking,Yes,74
0,56,54,0,101,8,Front Yard Parking,Yes,109
0,20,13,0,98,1,Boulevard Cafe,No,99
0,47,41,4,78,0,Appeal - Front Yard Parking,Yes,78
0,48,42,4,83,0,Appeal - Front Yard Parking,Yes,83
0,11,10,0,20,0,Front Yard Parking,Yes,20
0,32,29,2,40,7,Front Yard Parking,Yes,47
0,26,26,0,42,0,Front Yard Parking,Yes,42
0,3,3,0,24,0,Commercial Boulevard Parking,No,24
0,36,35,0,92,5,Front Yard Parking,Yes,97
0,7,7,0,19,0,Front Yard Parking,Yes,19
0,32,31,0,38,0,Front Yard Parking,Yes,38
0,63,55,8,99,3,Front Yard Parking,Yes,102
0,30,19,8,53,2,Traffic Calming,Yes,55
0,70,41,25,146,17,Traffic Calming,No,163
0,33,31,1,42,0,Appeal - Front Yard Parking,Yes,42
0,25,20,4,94,3,Appeal - Front Yard Parking,Yes,97
0,29,12,17,61,4,Appeal - Front Yard Parking,Yes,65
0,16,12,4,36,2,Appeal - Front Yard Parking,Yes,38
0,32,30,2,64,2,Appeal - Front Yard Parking,Yes,66
0,54,50,0,92,4,Appeal - Front Yard Parking,Yes,96
0,53,22,27,135,0,Appeal - Front Yard Parking,Yes,135
0,26,12,9,69,1,Appeal - Front Yard Parking,Yes,70
0,46,40,1,90,17,Front Yard Parking,Yes,107
0,41,41,0,61,4,Front Yard Parking,Yes,65
0,28,24,0,35,4,Front Yard Parking,Yes,39
0,40,16,17,139,1,Permit Parking,Yes,140
0,25,15,7,91,1,Boulevard Cafe,Yes,92
0,56,44,8,203,2,Permit Parking,Yes,205
0,10,7,3,18,4,Permit Parking,Yes,22
0,34,29,0,76,0,Front Yard Parking,Yes,76
0,35,25,10,64,1,Boulevard Cafe,Yes,65
0,16,13,1,52,2,Front Yard Parking,Yes,54
0,27,25,1,55,5,Front Yard Parking,Yes,60
0,36,33,2,47,3,Front Yard Parking,Yes,50
0,45,36,4,132,1,Front Yard Parking,Yes,133
0,5,4,0,11,0,Front Yard Parking,Yes,11
0,24,24,0,40,0,Front Yard Parking,Yes,40
0,26,12,11,58,3,Permit Parking,Yes,61
0,66,16,47,119,2,Permit Parking,Yes,121
0,34,31,2,103,4,Appeal - Front Yard Parking,Yes,107
0,56,54,0,94,3,Front Yard Parking,Yes,97
0,13,13,0,35,6,Front Yard Parking,Yes,41
0,35,34,0,67,7,Front Yard Parking,Yes,74
0,20,4,16,37,0,Appeal - Front Yard Parking,Yes,37
0,23,22,1,31,0,Front Yard Parking,Yes,31
0,15,6,7,19,2,Permit Parking,Yes,21
2,62,32,25,150,17,Permit Parking,Yes,167
0,34,8,26,54,3,Permit Parking,Yes,57
0,52,35,14,109,2,Front Yard Parking,Yes,111
0,58,53,0,77,2,Appeal - Front Yard Parking,Yes,79
0,53,50,2,99,1,Front Yard Parking,Yes,100
0,59,57,0,99,3,Front Yard Parking,Yes,102
2,79,66,5,175,10,Appeal - Front Yard Parking,Yes,185
0,28,24,0,78,1,Appeal - Front Yard Parking,Yes,79
0,45,40,0,111,5,Front Yard Parking,Yes,116
1,66,53,3,162,3,Appeal - Front Yard Parking,Yes,165
0,54,40,7,129,1,Appeal - Front Yard Parking,Yes,130
0,85,59,21,125,13,Appeal - Front Yard Parking,Yes,138
0,3,2,1,11,3,Boulevard Cafe,Yes,14
0,42,7,28,75,12,Boulevard Cafe,Yes,87
0,46,29,11,99,0,Front Yard Parking,Yes,99
0,12,12,0,26,0,Front Yard Parking,Yes,26
0,52,43,2,108,7,Front Yard Parking,Yes,115
0,36,30,0,90,6,Front Yard Parking,Yes,96
0,23,21,0,40,0,Front Yard Parking,Yes,40
0,33,25,0,64,0,Front Yard Parking,Yes,64
0,42,29,8,82,16,Front Yard Parking,Yes,98
0,45,36,6,78,16,Front Yard Parking,Yes,94
0,15,15,0,34,0,Front Yard Parking,Yes,34
0,47,41,2,115,1,Appeal - Front Yard Parking,Yes,116
0,40,34,5,105,6,Appeal - Front Yard Parking,Yes,111
0,19,17,2,65,5,Appeal - Front Yard Parking,Yes,70
0,23,15,8,48,0,Permit Parking,Yes,48
0,12,12,0,17,1,Front Yard Parking,Yes,18
0,12,8,2,40,4,Appeal - Front Yard Parking,Yes,44
0,13,6,7,20,1,Traffic Calming,Yes,21
0,97,63,30,224,14,Traffic Calming,No,238
0,30,25,2,71,13,Traffic Calming,No,84
0,13,13,0,38,1,Boulevard Cafe,Yes,39
0,39,33,2,106,0,Front Yard Parking,Yes,106
0,20,17,0,40,6,Front Yard Parking,Yes,46
0,46,37,8,75,0,Front Yard Parking,Yes,75
0,68,56,6,146,14,Traffic Calming,No,160
0,41,31,2,87,1,Front Yard Parking,Yes,88
0,37,35,0,75,0,Front Yard Parking,Yes,75
0,28,20,4,77,0,Appeal - Front Yard Parking,Yes,77
0,55,44,10,112,8,Front Yard Parking,Yes,120
0,6,1,5,49,0,Boulevard Cafe,No,49
0,5,4,1,32,6,Boulevard Cafe,No,38
0,56,30,21,89,0,Traffic Calming,Yes,89
0,124,86,23,267,4,Traffic Calming,No,271
0,75,54,19,130,2,Traffic Calming,Yes,132
0,55,43,7,87,2,Front Yard Parking,Yes,89
0,32,28,3,101,2,Appeal - Front Yard Parking,Yes,103
0,6,6,0,21,0,Appeal - Front Yard Parking,Yes,21
0,55,19,33,121,1,Appeal - Front Yard Parking,Yes,122
0,31,23,8,111,9,Appeal - Front Yard Parking,Yes,120
0,31,10,20,49,0,Appeal - Front Yard Parking,Yes,49
0,23,18,3,44,7,Appeal - Front Yard Parking,Yes,51
0,58,40,10,142,0,Appeal - Front Yard Parking,Yes,142
0,32,30,1,63,0,Appeal - Front Yard Parking,Yes,63
0,11,11,0,28,0,Appeal - Front Yard Parking,Yes,28
0,67,55,7,127,2,Appeal - Front Yard Parking,Yes,129
0,55,49,4,91,2,Front Yard Parking,Yes,93
0,54,39,0,116,12,Front Yard Parking,Yes,128
0,44,32,4,112,8,Front Yard Parking,Yes,120
0,30,26,2,67,1,Appeal - Front Yard Parking,Yes,68
1,93,46,32,194,0,Traffic Calming,No,194
0,21,16,2,81,7,Front Yard Parking,Yes,88
0,33,29,2,52,2,Front Yard Parking,Yes,54
0,27,13,8,53,1,Front Yard Parking,Yes,54
4,519,303,161,1158,100,Traffic Calming,No,1258
0,18,14,3,31,0,Traffic Calming,Yes,31
0,38,27,7,64,3,Traffic Calming,Yes,67
0,31,20,7,121,8,Front Yard Parking,Yes,129
0,6,5,1,35,4,Boulevard Cafe,No,39
0,42,27,12,114,5,Appeal - Front Yard Parking,Yes,119
0,48,14,29,105,12,Boulevard Cafe,Yes,117
0,11,8,3,25,1,Boulevard Cafe,Yes,26
0,21,16,5,80,13,Boulevard Cafe,Yes,93
0,31,4,18,130,7,Boulevard Cafe,No,137
0,11,9,0,27,0,Boulevard Cafe,Yes,27
0,133,88,40,251,28,Traffic Calming,Yes,279
0,7,6,0,57,0,Boulevard Cafe,No,57
0,112,78,24,185,2,Traffic Calming,Yes,187
0,37,20,15,75,6,Boulevard Cafe,Yes,81
0,8,1,7,39,0,Boulevard Cafe,No,39
0,109,75,21,246,19,Traffic Calming,No,265
0,32,22,8,105,2,Traffic Calming,No,107
0,57,44,7,119,1,Traffic Calming,No,120
0,53,18,34,123,6,Appeal - Front Yard Parking,Yes,129
0,51,17,33,123,6,Appeal - Front Yard Parking,Yes,129
0,32,16,12,71,5,Appeal - Front Yard Parking,Yes,76
0,3,2,1,166,60,Boulevard Cafe,No,226
0,18,5,9,105,9,Boulevard Cafe,No,114
0,18,7,7,53,2,Traffic Calming,No,55
0,32,29,0,40,0,Front Yard Parking,Yes,40
0,28,17,9,45,0,Front Yard Parking,Yes,45
0,32,8,24,58,0,Permit Parking,Yes,58
0,1,1,0,2,2,Traffic Calming,No,4
0,17,4,13,50,12,Permit Parking,Yes,62
0,41,8,30,65,3,Front Yard Parking,Yes,68
0,101,71,26,183,5,Traffic Calming,Yes,188
0,87,66,11,194,4,Traffic Calming,No,198
0,74,51,18,148,75,Traffic Calming,No,223
0,53,44,7,88,21,Traffic Calming,Yes,109
0,36,23,8,97,1,Boulevard Cafe,Yes,98
0,28,18,7,55,0,Traffic Calming,No,55
0,11,9,1,25,0,Traffic Calming,No,25
0,25,20,3,42,0,Traffic Calming,Yes,42
0,28,25,3,41,0,Traffic Calming,Yes,41
0,42,37,0,73,5,Front Yard Parking,Yes,78
0,22,17,5,56,1,Front Yard Parking,Yes,57
0,25,13,6,84,2,Front Yard Parking,Yes,86
0,16,14,2,19,0,Appeal - Front Yard Parking,Yes,19
0,49,26,22,157,23,Traffic Calming,No,180
0,82,60,9,527,28,Permit Parking,No,555
0,28,26,0,43,0,Front Yard Parking,Yes,43
0,42,32,9,116,8,Front Yard Parking,Yes,124
0,30,27,1,84,12,Appeal - Front Yard Parking,Yes,96
0,57,19,38,137,9,Appeal - Front Yard Parking,Yes,146
0,62,42,10,127,0,Appeal - Front Yard Parking,Yes,127
0,46,39,5,65,5,Appeal - Front Yard Parking,Yes,70
0,31,15,14,71,2,Appeal - Front Yard Parking,Yes,73
0,36,16,19,80,3,Appeal - Front Yard Parking,Yes,83
0,15,12,3,19,0,Proposed Business Improvement Area,Yes,19
0,15,12,2,46,4,Front Yard Parking,Yes,50
0,33,5,28,148,12,Boulevard Cafe,No,160
2,32,29,1,58,4,Front Yard Parking,Yes,62
0,42,29,13,88,0,Front Yard Parking,Yes,88
0,6,0,6,45,9,Permit Parking,No,54
0,33,16,10,102,6,Boulevard Cafe,Yes,108
1,32,12,19,63,6,Traffic Calming,Yes,69
0,36,28,8,108,9,Traffic Calming,No,117
0,29,24,1,59,0,Front Yard Parking,Yes,59
0,38,33,2,88,2,Front Yard Parking,Yes,90
0,140,71,60,261,14,Traffic Calming â€“ Island,Yes,275
0,229,81,141,371,25,Traffic Calming â€“ Island,Yes,396
0,2,1,1,18,14,Boulevard Cafe,No,32
0,24,13,11,66,4,Front Yard Parking,Yes,70
0,32,7,24,54,17,Appeal - Front Yard Parking,Yes,71
0,31,25,1,46,10,Appeal - Front Yard Parking,Yes,56
0,37,27,1,70,4,Front Yard Parking,Yes,74
0,52,31,21,74,3,Traffic Calming,Yes,77
0,94,61,9,147,3,Appeal - Front Yard Parking,Yes,150
0,19,16,1,37,8,Front Yard Parking,Yes,45
0,25,21,0,339,63,Traffic Calming,No,402
0,34,19,6,65,8,Traffic Calming,Yes,73
0,73,36,33,150,15,Traffic Calming,No,165
0,19,14,3,36,6,Traffic Calming,Yes,42
0,53,43,10,114,15,Business Improvement Area,Yes,129
0,148,97,25,323,4,Traffic Calming,No,327
0,11,5,6,13,0,Front Yard Parking,Yes,13
0,46,38,8,93,7,Front Yard Parking,Yes,100
0,54,29,23,111,10,Traffic Calming,No,121
0,22,16,6,81,8,Permit Parking,Yes,89
0,20,14,3,62,5,Boulevard Cafe,Yes,67
0,40,39,1,161,57,Boulevard Cafe,No,218
0,47,30,16,121,8,Appeal - Front Yard Parking,Yes,129
0,44,29,14,123,6,Appeal - Front Yard Parking,Yes,129
0,50,37,9,91,1,Traffic Calming,Yes,92
0,174,119,37,372,15,Traffic Calming,No,387
0,54,43,11,73,2,Traffic Calming,Yes,75
0,57,32,23,110,5,Traffic Calming,Yes,115
0,36,18,15,62,3,Traffic Calming,Yes,65
0,39,30,7,147,7,Boulevard Cafe,Yes,154
0,74,69,2,110,3,Front Yard Parking,Yes,113
0,21,6,13,60,0,Appeal - Front Yard Parking,Yes,60
0,31,17,6,85,7,Boulevard Cafe,Yes,92
0,23,17,5,74,0,Appeal - Front Yard Parking,Yes,74
0,77,56,11,123,2,Traffic Calming,Yes,125
0,56,45,8,111,2,Traffic Calming,No,113
0,58,34,24,107,0,Traffic Calming,Yes,107
0,3,3,0,10,0,Traffic Calming,No,10
0,53,29,23,72,1,Traffic Calming,Yes,73
0,5,5,0,27,1,Front Yard Parking,No,28
0,52,45,0,79,0,Front Yard Parking,Yes,79
0,72,43,16,220,15,Traffic Calming,No,235
0,60,36,7,200,6,Traffic Calming,No,206
0,40,17,12,78,11,Traffic Calming,Yes,89
0,57,43,11,94,1,Traffic Calming,Yes,95
0,30,8,21,50,0,Front Yard Parking,Yes,50
0,42,34,1,82,1,Appeal - Front Yard Parking,Yes,83
0,3,2,1,11,0,Traffic Calming,No,11
0,10,9,0,42,0,Traffic Calming,No,42
0,34,34,0,49,0,Traffic Calming,Yes,49
0,41,36,2,87,5,Front Yard Parking,Yes,92
0,12,9,0,13,0,Front Yard Parking,Yes,13
0,47,38,5,96,2,Front Yard Parking,Yes,98
0,39,29,6,139,6,Appeal - Front Yard Parking,Yes,145
0,17,12,4,52,2,Boulevard Cafe,Yes,54
0,57,30,5,139,12,Appeal - Front Yard Parking,Yes,151
0,53,46,2,96,0,Appeal - Front Yard Parking,Yes,96
0,31,30,0,45,1,Front Yard Parking,Yes,46
0,31,11,8,94,11,Boulevard Cafe,Yes,105
0,28,24,1,71,10,Appeal - Front Yard Parking,Yes,81
0,12,12,0,51,2,Appeal - Front Yard Parking,No,53
0,41,33,1,73,0,Front Yard Parking,Yes,73
0,33,26,3,68,0,Front Yard Parking,Yes,68
0,36,32,2,75,4,Front Yard Parking,Yes,79
0,19,19,0,30,0,Front Yard Parking,Yes,30
0,101,34,64,341,56,Permit Parking,Yes,397
0,26,3,17,173,5,Permit Parking,No,178
0,43,8,32,238,26,Permit Parking,No,264
0,33,33,0,64,0,Front Yard Parking,Yes,64
0,23,23,0,47,2,Front Yard Parking,Yes,49
0,21,21,0,56,0,Front Yard Parking,Yes,56
0,38,21,15,54,2,Appeal - Front Yard Parking,Yes,56
0,26,24,0,70,3,Appeal - Front Yard Parking,Yes,73
0,46,37,5,62,0,Appeal - Front Yard Parking,Yes,62
0,36,22,9,164,1,Appeal - Front Yard Parking,No,165
0,46,42,0,140,11,Appeal - Front Yard Parking,Yes,151
0,33,26,5,50,1,Boulevard Cafe,Yes,51
0,25,18,7,62,9,Traffic Calming,No,71
1,31,15,14,117,2,Traffic Calming,No,119
0,28,12,14,59,1,Appeal - Front Yard Parking,Yes,60
0,53,23,23,176,9,Appeal - Front Yard Parking,Yes,185
1,49,43,4,80,2,Traffic Calming,Yes,82
0,20,14,3,33,5,Front Yard Parking,Yes,38
0,17,15,0,83,5,Front Yard Parking,No,88
0,82,61,12,593,23,Traffic Calming,No,616
0,22,13,8,90,5,Permit Parking,No,95
0,58,23,33,226,8,Permit Parking,Yes,234
0,39,31,5,62,7,Traffic Calming,Yes,69
0,123,96,21,173,19,Traffic Calming,Yes,192
0,37,31,4,60,2,Appeal - Front Yard Parking,Yes,62
0,37,31,3,60,2,Appeal - Front Yard Parking,Yes,62
0,11,11,0,11,0,Appeal - Front Yard Parking,Yes,11
0,52,43,8,76,0,Appeal - Front Yard Parking,Yes,76
0,54,42,12,105,1,Appeal - Front Yard Parking,Yes,106
0,13,13,0,13,0,Appeal - Front Yard Parking,Yes,13
0,32,29,0,69,7,Front Yard Parking,Yes,76
0,41,33,4,104,3,Front Yard Parking,Yes,107
0,29,27,0,59,0,Front Yard Parking,Yes,59
0,32,24,5,44,2,Front Yard Parking,Yes,46
0,63,56,2,118,7,Front Yard Parking,Yes,125
1,47,39,0,71,0,Front Yard Parking,Yes,71
0,7,7,0,20,0,Proposed Business Improvement Area,Yes,20
0,30,25,3,61,6,Appeal - Front Yard Parking,Yes,67
0,33,14,17,67,11,Front Yard Parking,Yes,78
1,49,23,23,106,0,Appeal - Front Yard Parking,Yes,106
0,43,13,30,80,4,Appeal - Front Yard Parking,Yes,84
0,42,37,0,57,2,Appeal - Front Yard Parking,Yes,59
0,91,86,1,175,25,Front Yard Parking,Yes,200
0,49,33,4,174,9,Front Yard Parking,Yes,183
0,35,29,3,65,10,Front Yard Parking,Yes,75
0,32,28,0,116,12,Front Yard Parking,Yes,128
0,120,53,50,315,28,Traffic Calming,No,343
0,7,5,1,35,0,Appeal - Front Yard Parking,No,35
0,122,51,54,302,33,Traffic Calming,No,335
0,13,10,2,106,29,Boulevard Cafe,No,135
0,13,11,0,19,0,Permit Parking,Yes,19
0,33,28,0,57,1,Front Yard Parking,Yes,58
0,58,48,6,104,0,Front Yard Parking,Yes,104
0,5,4,0,21,0,Appeal - Front Yard Parking,No,21
0,10,8,1,36,6,Appeal - Front Yard Parking,Yes,42
0,11,9,0,43,0,Front Yard Parking,Yes,43
0,19,11,8,61,2,Commercial Boulevard Parking,Yes,63
0,35,23,10,55,0,Traffic Calming,Yes,55
0,43,28,15,82,4,Appeal - Front Yard Parking,Yes,86
0,41,34,5,103,0,Front Yard Parking,Yes,103
0,48,43,5,102,2,Front Yard Parking,Yes,104
1,131,107,16,202,0,Traffic Calming,Yes,202
0,25,22,1,74,1,Appeal - Front Yard Parking,Yes,75
0,34,31,0,57,7,Appeal - Front Yard Parking,Yes,64
0,31,20,9,167,17,Boulevard Cafe,No,184
0,8,8,0,16,0,Front Yard Parking,Yes,16
0,93,72,14,131,5,Traffic Calming,Yes,136
0,34,32,0,55,1,Appeal - Front Yard Parking,Yes,56
0,37,33,0,84,1,Front Yard Parking,Yes,85
0,66,46,15,151,48,Traffic Calming,No,199
0,51,23,27,73,2,Appeal - Front Yard Parking,Yes,75
0,38,31,2,74,0,Appeal - Front Yard Parking,Yes,74
0,76,67,1,128,3,Front Yard Parking,Yes,131
0,61,31,6,143,2,Front Yard Parking,Yes,145
0,56,49,4,90,14,Traffic Calming,Yes,104
0,92,74,15,145,12,Traffic Calming,Yes,157
0,44,40,3,155,4,Boulevard Cafe,Yes,159
0,24,12,10,197,7,Boulevard Cafe,No,204
0,37,31,0,55,0,Front Yard Parking,Yes,55
0,25,23,2,69,15,Front Yard Parking,Yes,84
0,103,77,20,187,9,Traffic Calming,Yes,196
0,30,16,11,59,1,Front Yard Parking,Yes,60
0,53,43,5,94,1,Front Yard Parking,Yes,95
0,30,28,2,64,0,Front Yard Parking,Yes,64
0,28,28,0,59,4,Front Yard Parking,Yes,63
0,101,37,52,149,5,Traffic Calming,Yes,154
0,136,100,24,270,7,Traffic Calming,Yes,277
0,69,45,15,148,9,Traffic Calming,No,157
0,0,0,0,3,0,Traffic Calming,No,3
1,62,46,9,92,2,Permit Parking,Yes,94
1,59,48,1,113,2,Front Yard Parking,Yes,115
0,39,35,3,81,3,Front Yard Parking,Yes,84
0,29,15,13,276,47,Boulevard Cafe,No,323
0,38,33,1,76,0,Front Yard Parking,Yes,76
0,28,14,9,85,5,Front Yard Parking,Yes,90
0,37,35,0,87,5,Front Yard Parking,Yes,92
0,52,38,5,95,4,Front Yard Parking,Yes,99
0,45,39,1,106,11,Front Yard Parking,Yes,117
0,40,5,35,63,3,Boulevard Cafe,Yes,66
0,22,19,3,133,21,Boulevard Cafe,No,154
0,46,40,4,103,9,Front Yard Parking,Yes,112
0,48,38,3,121,4,Boulevard Cafe,Yes,125
0,56,47,3,83,2,Front Yard Parking,Yes,85
0,11,10,0,17,0,Traffic Calming,Yes,17
0,47,46,0,117,0,Front Yard Parking,Yes,117
0,27,18,4,54,0,Front Yard Parking,Yes,54
0,25,15,10,50,5,Appeal - Front Yard Parking,Yes,55
0,110,60,46,191,7,Traffic Calming,Yes,198
0,29,23,5,83,3,Traffic Calming,No,86
0,66,51,10,188,16,Traffic Calming,No,204
0,46,35,8,84,2,Front Yard Parking,Yes,86
0,18,13,2,29,1,Front Yard Parking,Yes,30
0,13,8,5,62,27,Boulevard Cafe,No,89
0,49,39,7,80,0,Traffic Calming,Yes,80
0,204,148,41,816,62,Traffic Calming,No,878
0,33,25,6,111,11,Traffic Calming,No,122
0,158,125,30,262,20,Traffic Calming,Yes,282
0,168,137,22,589,63,Traffic Calming,No,652
0,24,4,8,75,1,Boulevard Cafe,Yes,76
0,8,8,0,20,0,Traffic Calming,No,20
0,36,28,5,73,0,Traffic Calming,No,73
0,20,4,13,60,6,Boulevard Cafe,Yes,66
0,38,19,16,51,2,Front Yard Parking,Yes,53
0,20,11,6,56,2,Front Yard Parking,Yes,58
0,34,28,0,97,3,Front Yard Parking,Yes,100
0,32,26,0,66,1,Appeal - Front Yard Parking,Yes,67
0,29,18,10,164,55,Boulevard Cafe,No,219
0,45,31,10,139,4,Traffic Calming,No,143
0,116,104,9,280,22,Business Improvement Area,Yes,302
0,41,40,1,107,4,Front Yard Parking,Yes,111
0,32,26,0,68,0,Front Yard Parking,Yes,68
0,26,20,4,215,40,Boulevard Cafe,No,255
0,77,60,10,205,49,Traffic Calming,No,254
0,69,44,23,162,2,Permit Parking,Yes,164
0,22,13,2,60,2,Boulevard Cafe,Yes,62
0,49,34,11,166,3,Front Yard Parking,Yes,169
0,26,21,0,39,3,Front Yard Parking,Yes,42
1,37,24,4,76,2,Front Yard Parking,Yes,78
0,24,18,4,47,7,Permit Parking,Yes,54
0,77,49,13,209,5,Permit Parking,Yes,214
0,309,160,133,522,4,Traffic Calming,Yes,526
0,82,64,12,128,0,Traffic Calming,Yes,128
0,41,38,0,118,3,Front Yard Parking,Yes,121
0,40,35,2,68,0,Front Yard Parking,Yes,68
0,29,18,10,77,6,Boulevard Cafe,Yes,83
0,26,19,6,74,0,Boulevard Cafe,Yes,74
0,8,2,6,17,1,Commercial Boulevard Parking,Yes,18
0,68,59,3,81,2,Front Yard Parking,Yes,83
0,34,30,1,59,0,Front Yard Parking,Yes,59
0,42,33,7,74,0,Front Yard Parking,Yes,74
0,29,22,7,62,6,Front Yard Parking,Yes,68
0,39,29,9,75,0,Front Yard Parking,Yes,75
0,13,10,1,16,0,Front Yard Parking,Yes,16
0,19,16,0,35,0,Front Yard Parking,Yes,35
0,43,31,8,92,5,Front Yard Parking,Yes,97
0,23,20,1,57,3,Front Yard Parking,Yes,60
0,30,18,11,105,3,Traffic Calming,No,108
0,0,0,0,5,0,Traffic Calming,No,5
0,24,8,16,56,0,Permit Parking,Yes,56
0,27,16,6,58,10,Front Yard Parking,Yes,68
0,48,25,13,81,9,Front Yard Parking,Yes,90
0,26,23,2,81,0,Front Yard Parking,Yes,81
0,20,20,0,34,0,Boulevard Cafe,Yes,34
0,38,30,0,56,5,Front Yard Parking,Yes,61
0,16,4,9,31,0,Commercial Boulevard Parking,Yes,31
0,22,21,0,49,0,Front Yard Parking,Yes,49
0,4,4,0,9,0,Commercial Boulevard Parking,Yes,9
0,35,21,13,77,3,Permit Parking,Yes,80
0,22,22,0,54,1,Front Yard Parking,Yes,55
0,42,41,0,102,4,Front Yard Parking,Yes,106
0,12,9,3,31,0,Front Yard Parking,Yes,31
0,65,52,8,121,1,Traffic Calming,Yes,122
0,13,8,4,49,9,Traffic Calming,No,58
0,47,42,0,78,2,Front Yard Parking,Yes,80
0,36,33,3,44,0,Traffic Calming,Yes,44
0,31,14,17,59,0,Traffic Calming,Yes,59
0,62,55,2,92,0,Front Yard Parking,Yes,92
0,25,20,1,34,2,Front Yard Parking,Yes,36
0,23,9,12,139,9,Boulevard Cafe,No,148
0,27,2,25,66,3,Boulevard Cafe,Yes,69
0,48,18,28,132,20,Boulevard Cafe,Yes,152
0,275,100,151,1753,125,Boulevard Cafe,No,1878
1,297,197,68,527,12,Traffic Calming,Yes,539
3,128,79,42,199,3,Traffic Calming,Yes,202
0,126,61,50,214,7,Traffic Calming,Yes,221
0,11,9,2,19,0,Front Yard Parking,Yes,19
0,44,42,0,72,2,Front Yard Parking,Yes,74
0,55,40,10,103,2,Front Yard Parking,Yes,105
0,20,16,0,32,2,Front Yard Parking,Yes,34
0,24,19,4,47,0,Front Yard Parking,Yes,47
0,43,23,16,136,1,Boulevard Cafe,Yes,137
0,124,81,22,331,38,Traffic Calming,No,369
0,165,67,66,522,17,Traffic Calming,No,539
0,28,21,0,51,5,Front Yard Parking,Yes,56
0,49,45,4,79,0,Front Yard Parking,Yes,79
0,33,28,3,58,5,Front Yard Parking,Yes,63
0,19,16,1,46,0,Boulevard Cafe,Yes,46
0,49,7,38,90,2,Boulevard Cafe,Yes,92
0,120,82,28,597,114,Traffic Calming,No,711
0,16,14,2,40,0,Front Yard Parking,Yes,40
0,36,27,6,52,0,Front Yard Parking,Yes,52
0,72,29,34,124,10,Permit Parking,Yes,134
0,40,31,1,94,2,Boulevard Cafe,Yes,96
0,50,30,14,125,3,Boulevard Cafe,Yes,128
0,52,41,6,100,1,Front Yard Parking,Yes,101
0,27,17,9,125,4,Front Yard Parking,No,129
0,43,34,2,127,4,Front Yard Parking,Yes,131
0,35,30,5,61,1,Front Yard Parking,Yes,62
0,27,15,11,91,5,Traffic Calming,No,96
0,98,75,13,269,3,Traffic Calming,No,272
0,35,23,1,112,1,Front Yard Parking,Yes,113
0,17,16,1,56,0,Business Improvement Area,Yes,56
0,63,55,2,139,1,Front Yard Parking,Yes,140
0,32,25,5,68,0,Front Yard Parking,Yes,68
0,24,14,5,39,2,Front Yard Parking,Yes,41
0,34,25,5,129,30,Boulevard Cafe,Yes,159
0,54,40,12,92,3,Traffic Calming,Yes,95
0,115,73,36,181,6,Traffic Calming,Yes,187
0,162,112,35,209,2,Traffic Calming,Yes,211
0,55,48,5,133,22,Front Yard Parking,Yes,155
0,61,17,42,132,5,Permit Parking,Yes,137
0,50,31,12,107,6,Boulevard Cafe,Yes,113
0,28,6,20,118,10,Boulevard Cafe,No,128
0,20,15,3,66,1,Boulevard Cafe,Yes,67
0,67,55,11,130,6,Front Yard Parking,Yes,136
0,25,9,16,51,2,Traffic Calming,No,53
0,69,50,11,135,10,Front Yard Parking,Yes,145
0,31,25,3,63,0,Front Yard Parking,Yes,63
0,27,17,10,35,0,Front Yard Parking,Yes,35
0,34,31,0,60,0,Front Yard Parking,Yes,60
0,33,18,6,195,2,Front Yard Parking,No,197
0,44,38,0,89,5,Front Yard Parking,Yes,94
0,45,30,13,98,4,Front Yard Parking,Yes,102
0,78,60,13,145,22,Traffic Calming,Yes,167
0,18,14,4,44,2,Commercial Boulevard Parking,Yes,46
0,48,35,7,129,9,Traffic Calming,No,138
0,74,53,13,183,21,Traffic Calming,No,204
0,95,47,32,353,38,Traffic Calming,No,391
0,39,27,11,76,2,Permit Parking,Yes,78
0,27,21,2,68,2,Boulevard Cafe,Yes,70
0,14,11,1,20,0,Front Yard Parking,Yes,20
0,16,15,0,30,0,Front Yard Parking,Yes,30
0,36,14,18,67,0,Boulevard Cafe,Yes,67
0,20,2,17,54,7,Boulevard Cafe,Yes,61
0,11,7,4,33,15,Permit Parking,Yes,48
0,48,40,0,84,0,Front Yard Parking,Yes,84
0,7,7,0,22,0,Permit Parking,Yes,22
0,40,30,5,97,3,Permit Parking,Yes,100
0,2,0,0,2,0,Permit Parking,Yes,2
0,49,30,16,148,2,Permit Parking,Yes,150
0,22,13,8,45,0,Permit Parking,Yes,45
0,13,11,1,46,0,Permit Parking,Yes,46
0,27,17,10,59,0,Permit Parking,Yes,59
0,54,30,20,276,5,Permit Parking,No,281
0,28,24,2,41,6,Boulevard Cafe,Yes,47
0,33,8,21,119,7,Boulevard Cafe,Yes,126
2,6,4,0,31,10,Permit Parking,No,41
0,84,11,63,176,1,Permit Parking,Yes,177
1,180,125,27,608,43,Traffic Calming,No,651
0,41,36,0,125,2,Front Yard Parking,Yes,127
0,34,18,13,68,0,Permit Parking,Yes,68
0,18,7,11,25,2,Boulevard Cafe,Yes,27
0,49,43,0,92,3,Front Yard Parking,Yes,95
2,133,42,57,461,21,Traffic Calming Safety Zone,No,482
0,79,64,14,138,0,Traffic Calming,Yes,138
0,51,37,7,172,63,Traffic Calming,No,235
0,61,54,3,90,9,Front Yard Parking,Yes,99
0,28,8,14,90,5,Boulevard Cafe,Yes,95
0,60,46,6,131,10,Traffic Calming,No,141
0,44,12,22,75,11,Traffic Calming,Yes,86
0,99,58,35,181,7,Traffic Calming,Yes,188
0,49,22,26,76,0,Traffic Calming,Yes,76
0,39,32,5,70,2,Traffic Calming,Yes,72
0,90,42,38,140,8,Traffic Calming,Yes,148
0,13,13,0,35,0,Front Yard Parking,Yes,35
0,63,53,2,117,10,Front Yard Parking,Yes,127
0,36,33,0,55,7,Front Yard Parking,Yes,62
0,14,13,1,51,9,Boulevard Cafe,Yes,60
0,59,51,5,110,5,Traffic Calming,Yes,115
0,71,54,14,126,6,Traffic Calming,Yes,132
0,75,68,0,125,8,Front Yard Parking,Yes,133
0,26,18,7,53,4,Front Yard Parking,Yes,57
0,11,1,10,26,0,Permit Parking,Yes,26
0,50,37,12,95,1,Permit Parking,Yes,96
0,25,24,0,63,11,Traffic Calming,No,74
0,43,34,6,96,10,Front Yard Parking,Yes,106
1,48,25,19,89,8,Front Yard Parking,Yes,97
0,45,24,19,125,2,Permit Parking,Yes,127
0,25,19,4,49,2,Appeal - Front Yard Parking,Yes,51
0,96,43,44,149,1,Permit Parking,Yes,150
0,50,40,4,69,9,Front Yard Parking,Yes,78
0,42,41,1,76,1,Front Yard Parking,Yes,77
0,22,14,1,84,1,Front Yard Parking,Yes,85
0,16,7,9,23,0,Front Yard Parking,Yes,23
0,16,7,9,23,0,Front Yard Parking,Yes,23
0,83,75,7,165,10,Business Improvement Area,Yes,175
0,43,33,6,77,3,Traffic Calming,Yes,80
0,36,32,1,54,2,Front Yard Parking,Yes,56
0,55,49,2,95,11,Front Yard Parking,Yes,106
0,78,42,32,135,6,Permit Parking,Yes,141
0,19,12,5,43,0,Traffic Calming Safety Zone,Yes,43
0,14,0,13,36,0,Permit Parking,Yes,36
0,49,40,5,99,8,Front Yard Parking,Yes,107
0,31,21,9,107,23,Permit Parking,Yes,130
0,130,80,33,353,23,Traffic Calming Safety Zone,Yes,376
0,40,32,6,67,5,Traffic Calming,Yes,72
0,45,35,4,108,5,Front Yard Parking,Yes,113
0,39,29,4,83,13,Front Yard Parking,Yes,96
0,35,27,8,40,1,Front Yard Parking,Yes,41
0,39,33,1,89,10,Front Yard Parking,Yes,99
0,19,2,16,42,10,Permit Parking,Yes,52
0,69,32,31,111,3,Permit Parking,Yes,114
0,40,25,11,89,2,Front Yard Parking,Yes,91
0,40,27,12,103,1,Front Yard Parking,Yes,104
0,11,7,0,26,4,Front Yard Parking,Yes,30
0,50,14,33,165,1,Permit Parking,Yes,166
0,25,10,12,69,3,Permit Parking,Yes,72
0,39,11,27,61,4,Permit Parking,Yes,65
0,11,11,0,105,0,Permit Parking,No,105
0,22,7,15,41,0,Permit Parking,Yes,41
0,54,41,10,89,8,Front Yard Parking,Yes,97
0,0,0,0,535,0,Permit Parking,No,535
0,0,0,0,53,0,Permit Parking,No,53
0,16,10,5,48,0,Permit Parking,Yes,48
0,84,42,33,192,0,Permit Parking,Yes,192
0,127,77,44,555,22,Permit Parking,No,577
0,102,47,49,211,9,Traffic Calming,No,220
0,68,58,6,103,3,Front Yard Parking,Yes,106
0,46,42,2,73,4,Front Yard Parking,Yes,77
0,53,27,25,96,10,Front Yard Parking,Yes,106
3,166,150,9,572,107,Traffic Calming,No,679
0,48,40,6,128,7,Traffic Calming,No,135
0,36,30,5,105,2,Traffic Calming,No,107
0,32,28,2,44,0,Traffic Calming,Yes,44
0,122,95,23,180,6,Traffic Calming,Yes,186
0,0,0,0,999,0,Business Improvement Area,No,999
0,1,1,0,245,0,Proposed Business Improvement Area,No,245
0,0,0,0,23,0,Proposed Business Improvement Area,No,23
2,55,53,0,101,3,Front Yard Parking,Yes,104
0,39,28,3,74,17,Front Yard Parking,Yes,91
0,98,24,68,169,1,Permit Parking,Yes,170
0,46,10,35,73,2,Permit Parking,Yes,75
0,45,8,34,65,0,Permit Parking,Yes,65
1,65,9,54,103,3,Permit Parking,Yes,106
0,18,1,16,42,0,Permit Parking,Yes,42
0,8,5,3,10,5,Permit Parking,Yes,15
0,0,0,0,32,0,Permit Parking,No,32
0,21,8,12,61,0,Traffic Calming,No,61
0,100,85,7,247,11,Traffic Calming,No,258
0,65,64,0,98,5,Front Yard Parking,Yes,103
0,62,50,5,123,6,Front Yard Parking,Yes,129
0,0,0,0,99,0,Traffic Calming,No,99
0,0,0,0,645,0,Traffic Calming Safety Zone,No,645
0,40,30,5,83,0,Traffic Calming,No,83
0,0,0,0,113,0,Permit Parking,No,113
0,41,29,7,155,24,Traffic Calming,No,179
0,41,35,0,60,2,Front Yard Parking,Yes,62
0,0,0,0,44,0,Permit Parking,No,44
0,0,0,0,88,0,Front Yard Parking,No,88
